1111111111111111111
1P0100C1000000000C1
1100000001C01011101
1C0V0V0001111000101
1V0000C10V0C1VC1001
11CV10V1000V101E0V1
1111111111111111111