11111111111111111
11C000000000C0V11
1000001V000001001
1000000000V000011
1P000000C10000001
110101100V0000011
11110C10000000011
1001E100C0V000101
11111111111111111